NO /Users/gautierchauvot/Documents/42/cubed/text.xmp
EA /Users/gautierchauvot/Documents/42/cubed/text.xmp
WE /Users/gautierchauvot/Documents/42/cubed/text.xmp
SO /Users/gautierchauvot/Documents/42/cubed/text.xmp

F 200,0,150
C 11,222,123





1111111
1001011
10W1111111
11111111