NO /Users/gautierchauvot/Documents/42/cubed/parsing_cubed.c
EA /Users/gautierchauvot/Documents/42/cubed/parsing_cubed.c
WE /Users/gautierchauvot/Documents/42/cubed/parsing_cubed.c
SO /Users/gautierchauvot/Documents/42/cubed/parsing_cubed.c

C 11,222,123
F 2000,0,150
F 111,333,444

1111
1001
1001
1111